+---+---+---+---+
|               |
+   +   +---+   +
|   |   |       |
+   +---+   +---+
|   |           |
+   +   +   +---+
|   |           |
+---+---+---+---+
