+---+---+---+---+
|       |       |
+   +---+   +   +
|   |       |   |
+   +   +---+   +
|       |       |
+   +---+   +---+
|   |           |
+---+---+---+---+
