+---+---+---+---+
|               |
+   +   +   +   +
|               |
+   +   +   +   +
|               |
+   +   +   +   +
|   |           |
+---+---+---+---+
