+---+---+---+---+
|               |
+   +   +   +   +
|               |
+   +   +   +   +
|               |
+   +   +   +   +
|               |
+---+---+---+---+
