+---+---+---+---+
|               |
+   +---+---+   +
|   |       |   |
+   +   +---+   +
|       |       |
+   +---+---+   +
|   |           |
+---+---+---+---+
