+---+---+---+---+---+---+---+---+---+---+---+---+---+---+---+---+---+---+---+---+---+---+---+---+---+---+---+---+---+---+---+---+
|   |                               |                                                                                           |
+   +   +---+---+---+---+---+---+   +   +---+---+---+---+---+---+---+---+---+---+---+---+---+---+---+---+---+---+---+   +   +   +
|       |               |       |   |   |   |   |   |   |   |   |                   |   |                       |   |   |   |   |
+   +---+   +---+---+   +   +   +   +   +   +   +   +   +   +   +   +   +   +   +   +   +---+   +---+   +---+   +   +---+   +   +
|       |   |           |   |   |       |                       |                   |           |       |                       |
+   +---+   +   +---+---+   +   +---+---+   +   +   +   +   +   +   +   +   +   +   +   +   +   +   +---+   +   +---+   +---+   +
|       |   |               |           |   |   |   |   |   |   |                   |   |   |       |       |       |   |       |
+   +---+   +---+---+---+---+---+---+   +   +---+---+---+---+   +   +   +   +   +   +---+   +   +   +   +   +---+   +   +---+   +
|   |       |                           |           |           |                   |       |   |       |               |       |
+   +   +---+   +---+---+---+---+---+---+---+---+   +---+   +---+   +   +   +   +   +   +---+   +---+   +---+   +---+   +   +   +
|   |   |       |                       |       |       |       |                   |               |               |       |   |
+   +   +   +---+   +   +   +   +   +   +   +   +---+   +---+   +---+---+---+---+---+---+   +---+   +---+---+---+   +   +   +   +
|   |   |   |                           |   |       |       |                       |   |   |       |           |       |   |   |
+   +   +   +   +   +   +   +   +   +   +   +   +   +---+   +---+---+---+---+---+   +   +   +   +   +   +   +   +   +---+   +   +
|   |   |   |                           |   |   |       |       |                   |           |   |           |           |   |
+   +   +   +   +   +   +   +   +   +   +   +   +   +   +---+   +---+   +---+---+---+   +---+---+   +   +   +   +---+   +   +   +
|   |   |   |                           |   |   |   |       |       |               |               |           |   |   |   |   |
+   +   +   +   +   +   +   +   +   +   +   +   +---+---+   +---+   +---+---+---+   +   +   +---+---+---+---+---+   +   +---+   +
|   |   |   |                           |   |           |       |       |       |   |   |   |           |   |               |   |
+   +   +   +   +   +   +   +   +   +   +   +---+---+   +---+   +---+   +   +   +   +   +   +   +   +---+   +---+   +---+   +   +
|   |   |   |                           |   |           |           |       |   |   |   |       |                       |   |   |
+   +   +   +   +   +   +   +   +   +   +   +   +---+---+---+---+   +---+   +   +   +   +---+   +---+   +---+   +---+   +   +   +
|   |   |   |                           |   |   |                       |   |   |   |       |       |   |           |       |   |
+   +   +   +---+---+---+---+---+---+---+   +   +   +---+---+---+---+---+---+   +   +   +   +---+   +---+---+---+---+---+---+   +
|   |   |                           |       |   |                               |       |       |                           |   |
+   +   +---+---+---+---+---+---+   +---+   +   +---+---+---+---+---+---+---+---+---+---+---+   +---+---+---+---+---+---+   +   +
|   |   |                       |   |       |                                       |                                   |   |   |
+   +   +   +---+---+---+---+---+   +   +---+---+---+---+---+---+---+---+---+---+   +---+---+---+---+---+---+---+---+   +   +   +
|   |   |                       |   |   |           |   |                           |           |                       |   |   |
+   +   +---+---+   +---+---+   +   +   +   +   +   +   +   +---+---+---+---+---+---+   +---+   +---+---+---+---+---+   +   +   +
|   |           |               |   |   |   |   |           |   |                   |   |       |                   |   |   |   |
+   +---+---+   +   +---+---+---+   +   +   +   +   +   +   +   +   +---+---+---+   +   +   +---+   +   +   +   +   +   +   +   +
|   |           |       |           |   |           |   |           |           |   |   |       |                   |   |   |   |
+   +   +---+   +   +---+   +---+---+   +   +   +   +   +   +   +   +   +   +   +   +   +---+   +   +   +   +   +   +   +   +   +
|   |   |       |       |           |       |   |           |   |               |   |   |       |                   |   |   |   |
+   +   +   +---+   +---+   +---+---+   +   +   +   +   +   +   +   +   +   +   +   +   +   +---+   +   +   +   +   +   +   +   +
|   |   |   |                       |   |           |   |           |           |   |   |       |                   |   |   |   |
+   +   +   +   +---+---+---+---+---+   +   +   +   +   +   +   +   +---+---+---+   +   +---+   +   +   +   +   +   +   +   +   +
|   |   |   |   |                   |   |   |   |           |   |                   |   |       |                   |   |   |   |
+   +   +   +   +   +   +   +   +   +   +   +   +   +   +   +---+---+---+---+---+---+   +   +---+---+---+---+---+---+   +   +   +
|   |       |   |                   |   |           |   |                               |       |                       |   |   |
+   +   +---+   +   +   +   +   +   +   +   +---+---+---+---+---+---+---+---+   +---+   +---+   +---+---+---+---+---+   +   +   +
|   |   |       |                   |   |   |                               |           |       |   |   |   |           |   |   |
+   +   +   +---+   +   +   +   +   +   +---+---+   +---+---+---+---+---+   +---+---+---+   +---+   +   +   +   +---+---+   +   +
|   |   |   |   |                   |           |                       |   |               |               |   |           |   |
+   +   +   +   +   +   +   +   +   +---+---+   +---+   +---+---+   +---+   +   +---+---+---+   +---+---+   +   +   +---+---+   +
|   |   |   |   |                   |       |       |                       |   |           |           |       |   |           |
+   +   +   +   +---+---+---+---+---+   +   +---+   +---+---+---+---+   +   +   +   +---+   +---+---+   +   +   +   +   +---+---+
|       |                       |   |   |   |   |                   |   |   |   |   |                   |   |   |   |           |
+---+   +---+---+---+---+---+   +   +   +   +   +---+---+---+---+   +   +   +   +   +   +---+---+---+---+---+   +   +---+---+   +
|       |       |   |           |   |       |   |               |   |   |       |   |   |                   |               |   |
+   +   +   +   +   +   +   +---+   +   +---+   +   +   +   +   +   +   +---+   +   +---+   +---+---+---+   +---+---+---+---+   +
|   |   |   |   |       |   |       |   |   |   |               |   |       |   |       |   |           |                   |   |
+   +   +   +   +   +---+   +   +---+   +   +   +   +   +   +   +   +---+   +   +---+   +   +   +   +   +   +---+---+---+   +   +
|   |       |   |       |   |       |   |       |               |           |   |       |   |           |   |               |   |
+   +---+   +   +   +   +   +---+   +   +   +   +   +   +   +   +---+---+---+   +   +---+   +   +   +   +   +   +---+---+---+   +
|       |   |       |                       |   |               |       |   |   |       |   |           |   |   |               |
+   +   +   +---+   +---+---+   +---+---+---+   +---+---+---+---+   +   +   +   +---+   +   +---+---+---+   +   +   +---+---+   +
|   |   |                                                           |       |           |                   |   |   |   |   |   |
+   +   +---+---+---+---+---+---+---+---+---+---+---+---+---+---+---+---+   +---+---+---+---+---+---+---+---+   +   +   +   +   +
|   |                                                                                                           |   |       |   |
+   +   +   +---+---+---+---+---+---+---+---+---+---+---+---+---+---+---+---+---+---+---+---+---+---+---+---+---+   +   +   +   +
|   |   |                                                                                                               |       |
+---+---+---+---+---+---+---+---+---+---+---+---+---+---+---+---+---+---+---+---+---+---+---+---+---+---+---+---+---+---+---+---+
