+---+---+---+---+
|               |
+   +---+---+   +
|   |   |       |
+   +   +   +---+
|   |           |
+   +---+---+   +
|   |           |
+---+---+---+---+
