+---+---+---+---+
|               |
+   +---+   +   +
|   |       |   |
+---+   +---+   +
|       |       |
+   +---+---+   +
|   |           |
+---+---+---+---+
