+---+---+---+---+
|               |
+   +---+---+   +
|   |       |   |
+   +   +   +   +
|   |   |       |
+   +   +---+   +
|   |       |   |
+---+---+---+---+
