+---+---+---+---+---+---+---+---+---+---+---+---+---+---+---+---+
|                           |   |   |                           |
+   +---+---+---+   +---+   +---+---+   +---+   +---+---+---+   +
|   |           |   |                       |   |           |   |
+   +---+---+   +   +   +---+---+---+---+   +   +   +---+---+   +
|           |   |   |                       |   |   |           |
+   +---+   +---+   +---+---+---+---+---+---+   +---+   +---+   +
|   |   |   |   |           |       |           |   |   |   |   |
+   +---+   +---+---+---+---+---+---+   +---+   +---+   +---+   +
|                   |                       |                   |
+   +---+---+   +   +---+---+   +---+---+---+---+---+---+---+   +
|   |       |   |   |       |   |   |       |       |           |
+   +---+   +   +   +   +---+   +---+---+   +   +   +   +---+   +
|       |   |   |   |   |               |   |   |   |   |       |
+---+   +   +   +   +---+   +---+---+   +---+   +   +   +   +   +
|   |   |   |       |   |   |       |   |   |       |   |   |   |
+   +   +---+   +   +   +   +   +   +   +   +   +   +   +   +   +
|   |   |       |   |   |   |           |   |   |   |   |   |   |
+---+   +---+   +   +---+   +---+---+   +---+   +   +   +   +   +
|       |   |   |   |   |               |   |   |   |   |       |
+   +---+   +   +   +   +---+---+---+---+   +   +   +   +---+   +
|   |       |       |           |           |       |           |
+   +---+---+---+   +---+---+---+---+---+---+---+   +---+---+   +
|               |                               |               |
+   +---+---+   +   +---+   +---+---+   +---+   +---+---+---+   +
|               |                               |   |       |   |
+   +---+---+---+   +---+---+---+---+---+---+   +---+---+   +   +
|   |   |   |       |           |           |           |   |   |
+   +   +---+   +   +   +---+---+---+---+   +   +---+   +   +   +
|   |   |       |   |   |               |   |           |   |   |
+   +   +   +---+   +---+   +---+---+   +---+   +---+   +---+   +
|   |   |                                       |   |           |
+---+---+---+---+---+---+---+---+---+---+---+---+---+---+---+---+
